111111111
10P001C01
100000001
10C001EC1
1000C1001
111111111