111111111
100000C01
10P000001
10C000E01
1000C0001
111111111