111111111
100001C01
100P00001
10C001EC1
1000C1001
111111111