11111111111111111111
100000000000C0000001
10000P000C00000000E1
100000000000001C0001
100000000000001C0001
100000000000001C0001
100000000000001C0001
100000000000001C0001
100000000000001C0001
100000000000001C0001
100000000000001C0001
100000000000001C0001
100000000000001C0001
100000000000001C0001
100000000000001C0001
100000000000001C0001
100000000000001C0001
100000000000001C0001
100000000000001C0001
100000000000001C0001
100000000000001C0001
100000000000001C0001
100000000000001C0001
100000000000001C0001
100000000000001C0001
100000000000001C0001
100000000000001C0001
100000000000001C0001
100000000000001C0001
100000000000001C0001
100000000000001C0001
100000000000001C0001
100000000000001C0001
100000000000001C0001
100000000000001C0001
100000000000001C0001
100000000000001C0001
100000000000001C0001
100000000000001C0001
100000000000001C0001
100000000000001C0001
100000000000001C0001
100000000000001C0001
100000000000001C0001
100000000000001C0001
100000000000001C0001
100000000000001C0001
100000000000001C0001
100000000000001C0001
100000000000001C0001
100000000000001C0001
100000000000001C0001
100000000000001C0001
100000000000001C0001
100000000000001C0001
100000000000001C0001
100000000000001C0001
100000000000001C0001
100000000000001C0001
100000000000001C0001
100000000000001C0001
100000000000001C0001
100000000000001C0001
100000000000001C0001
100000000000001C0001
100000000000001C0001
100000000000001C0001
100000000000001C0001
100000000000001C0001
100000000000001C0001
100000000000001C0001
100000000000001C0001
100000000000001C0001
100000000000001C0001
100000000000001C0001
100000000000001C0001
100000000000001C0001
100000000000001C0001
100000000000001C0001
100000000000001C0001
11111111111111111111