11111111111111111
100000C000000C001
10P00000000000001
1000C00E000000001
11111111111111111