11111111111111111
100000C000000C001
1000P0000000000E1
1000C000000000001
11111111111111111