111111111
100P000C1
10E111111
111111111