111111111
100P001C1
10E000001
111111111