111111111
100P000C1
10E000001
111111111